# Resources from graph.properties
alreadyConnected=节点已连接
cancel=取消
close=关闭
collapse expand=折叠/展开
containsValidationErrors=包含验证错误
done=完成
doubleClickOrientation=双击可更改方向
error=错误
errorSavingFile=保存文件时出错
ok=确定
updatingDocument=正在更新文档。请稍候。。。
updatingSelection=正在更新选择。请稍候。。。
#自定义资源
about=关于
actualSize=实际大小
add=添加
addLayer=添加层
addProperty=添加属性
addToExistingDrawing=添加到现有图形
addWaypoint=添加航路点
advanced=高级
align=对齐
alignment=对齐
allChangesLost=所有更改都将丢失！
angle=角度
apply=应用
arc=弧
arrange=排列
arrow=箭头
arrows=箭头
automatic=自动
autosave=自动保存
autosize=自动调整大小
back=后退
background=背景
backgroundColor=背景色
backgroundImage=背景图像
basic=基本
block=块
blockquote=blockquote
bold=粗体
border=边框
borderWidth=边框宽度
borderColor=边框颜色
bottom=底部
bottomAlign=底部对齐
bottomLeft=左下
bottomRight=右下
bulletedList=项目符号列表
cannotOpenFile=无法打开文件
center=中心
change=更改
changeOrientation=更改方向
circle=圆
classic=经典
clearDefaultStyle=清除默认样式
clearWaypoints=清除航路点
clipart=剪贴画
collapse=折叠
collapseExpand=折叠/展开
collapsible=可折叠
comic=漫画
connect=连接
connection=连接
connectionPoints=连接点
connectionArrows=连接箭头
constrainProportions=约束比例
copy=复制
copyConnect=连接时复制
copySize=副本大小
create=创建
curved=曲线
custom=自定义
cut=切割
dashed=虚线
decreaseIndent=减少缩进
default=默认值
delete=删除
deleteColumn=删除列
deleteRow=删除行
diagram=图表
diamond=钻石
diamondThin=金刚石（薄）
direction=方向
distribute=分发
divider=除法器
documentProperties=文档属性
dotted=点
dpi=DPI
drawing=绘制{1}
drawingEmpty=绘图为空
drawingTooLarge=绘图过大
duplicate=克隆
duplicateIt=重复{1}
east=东
edit=编辑
editData=编辑数据
editDiagram=编辑关系图
editImage=编辑图像
editLink=编辑链接
editStyle=编辑样式
editTooltip=编辑工具提示
enterGroup=输入组
enterValue=输入值
enterName=输入名称
enterPropertyName=输入属性名
entityRelation=实体关系
exitGroup=取消组合
expand=展开
export=导出
extras=附加
file=文件
fileNotFound=找不到文件
filename=文件名
fill=填充
fillColor=填充颜色
fitPage=一页
fitPageWidth=页面宽度
fitTwoPages=两页
fitWindow=调整窗口
flip=翻转
flipH=水平翻转
flipV=垂直翻转
font=字体
fontFamily=字体系列
fontColor=字体颜色
fontSize=字体大小
format=格式
formatPanel=格式面板
general=Allgemein
formatPdf=PDF格式
formatPng=PNG格式
formatGif=GIF
formatJpg=JPEG格式
formatSvg=SVG
formatXml=XML
formatted=格式化
formattedText=格式化文本
gap=间隙
glass=玻璃
general=常规
global=全局
gradient=渐变
gradientColor=颜色
grid=网格
gridSize=网格大小
group=组合
guides=指南
heading=标题
height=高度
help=帮助
hide=隐藏
hideIt=隐藏{1}
hidden=隐藏
home=主页
horizontal=水平
horizontalFlow=水平流
horizontalTree=水平树
html=HTML
id=ID
image=图像
images=图像
import=导入
increaseIndent=增加缩进
insert=插入
insertColumnBefore=向左插入列
insertColumnAfter=向右插入列
insertHorizontalRule=插入水平规则
insertImage=插入图像
insertLink=插入链接
insertRowBefore=在上面插入行
insertRowAfter=在下面插入行
invalidInput=无效输入
invalidName=无效名称
invalidOrMissingFile=无效或缺少文件
isometric=等轴测
italic=斜体
layers=图层
landscape=横向
laneColor=蓝颜色
layout=布局
left=左
leftAlign=左对齐
leftToRight=从左到右
line=边框
link=链接
lineJumps=换行
lineend=行尾
lineheight=行高
linestart=行头
linewidth=线宽
loading=加载
lockUnlock=锁定/解锁
manual=手册
middle=中间
misc=杂项
more=更多
moreResults=更多结果
move=移动
moveSelectionTo=将所选内容移动到{1}
navigation=导航
new=新建
noColor=无颜色
noFiles=没有文件
noMoreResults=没有更多结果
none=无
noResultsFor=没有{1}的结果
normal=正常
north=北
numberedList=编号列表
opacity=透明度
open=打开
openArrow=打开箭头
openFile=打开文件
openLink=打开链接
openSupported=支持的格式是从该软件保存的.XML文件
openInNewWindow=在新窗口中打开
openInThisWindow=在此窗口中打开
options=选项
organic=有机
orthogonal=直角
outline=轮廓
oval=椭圆形
pages=页
pageView=页面视图
pageScale=页面比例
pageSetup=页面设置
panTooltip=空格+拖动可滚动
paperSize=尺寸大小
paste=粘贴
pasteHere=粘贴到这里
pasteSize=粘贴大小
pattern=模式
perimeter=周长
placeholders=占位符
plusTooltip=单击以连接并克隆（按住ctrl键并单击以克隆，按住shift键并单击以连接）。拖动以连接（按住ctrl键并拖动以克隆）。
portrait=纵向
position=位置
posterPrint=海报打印
preview=预览
print=打印
radialTree=径向树
redo=重做
removeFormat=清除格式
removeFromGroup=从组中删除
removeIt=删除{1}
removeWaypoint=删除航路点
rename=重命名
renameIt=重命名{1}
replace=替换
replaceIt={1}已存在。要替换它吗？
replaceExistingDrawing=替换现有图形
reset=重置
resetView=重置视图
reverse=反向
right=右
rightAlign=右对齐
rightToLeft=从右向左
rotate=旋转
rotateTooltip=单击并拖动可旋转，单击可将形状仅旋转90度
rotation=旋转
rounded=圆角
save=保存
saveAs=另存为
saved=已保存
scrollbars=滚动条
search=搜索
searchShapes=搜索形状
selectAll=全选
selectEdges=选择边框
selectFont=选择字体
selectNone=取消选择
selectVertices=选择顶点
setAsDefaultStyle=设置为默认样式
shadow=阴影
shape=形状
sharp=尖锐
sidebarTooltip=单击展开。将形状拖放到关系图中。按住Shift键并单击可更改选择。按住Alt键并单击可插入和连接。
simple=简单
simpleArrow=简单箭头
size=大小
solid=固体
sourceSpacing=源间距
south=南
spacing=空间
straight=直线
strikethrough=删除线
strokeColor=线条颜色
style=样式
subscript=下标
superscript=上标
table=表格
targetSpacing=目标间距
text=数据绑定
textAlignment=文本对齐
textOpacity=文本不透明度
toBack=置于底层
toFront=置于顶层
tooltips=工具提示
top=顶部
topAlign=上对齐
topLeft=左上
topRight=右上
transparent=透明
turn=仅旋转90°形状
uml=UML
underline=下划线
undo=撤消
ungroup=解组
url=URL
untitledLayer=无标题层
vertical=垂直
verticalFlow=垂直流
verticalTree=垂直树
view=视图
waypoints=路径
west=西
width=宽度
wordWrap=自动换行
writingDirection=输入方向
zoom=缩放
zoomIn=放大
zoomOut=缩小
Preview=预览
dataSource=数据源
publish=发布
bind=绑定变量
